11111111111111111
10P0100000C000101
1000100100C000011
1000001E0000C0011
11111111111111111