111111111111111111111111111111
100100000000010011001000000001
1001000000C001001100100000C001
100100000000000011P01000000001
100100000000010011001000000001
1001C00000000100110010C0000001
100010000000001000000100000001
100010010000100111000100100011
100000100001000111000001E00011
100010010000100111000100100011
100010010000100111000100100011
100010010000100111000100100011
111111111111111111111111111111